g1 g1 b1 t1 g1 g1 g1 t1 g1 t1 g1 g1 g1 g1 t1 t2 g1 g1 g1 g1
g1 g1 g1 t1 t1 t1 g1 g1 g1 t1 g1 g1 g1 g1 g1 t1 g1 g1 g1 g1
g1 g1 g1 g1 t1 t1 g1 g1 g1 t1 g1 g1 g1 g1 g1 g1 t1 t1 t1 g1
g1 g1 g1 g1 g1 t1 t1 g1 t2 t1 g1 g1 g1 g1 g1 g1 g1 t1 t1 g1
g1 g1 g1 g1 g1 g1 t1 t1 g1 t1 g1 g1 g1 g1 g1 g1 g1 g1 g1 g1
g1 g1 g1 g1 g1 g1 g1 t1 t1 t1 g1 g1 g1 g1 g1 g1 g1 g1 g1 g1
g1 g1 g1 g1 g1 g1 g1 g1 t1 t1 g1 g1 g1 g1 g1 g1 g1 g1 g1 g1
g1 g1 g1 g1 g1 g1 g1 g1 g1 g1 g1 g1 g1 g1 g1 g1 g1 g1 g1 g1
g1 g1 g1 g1 g1 g1 g1 g1 g1 g1 g1 g1 g1 g1 g1 g1 g1 g1 g1 g1
g1 g1 g1 g1 g1 g1 g1 g1 g1 g1 g1 g1 g1 g1 g1 g1 g1 g1 g1 g1
g1 g1 g1 g1 g1 g1 g1 g1 g1 g1 g1 g1 g1 g1 g1 g1 g1 g1 g1 g1
g1 g1 g1 g1 g1 g1 g1 g1 g1 g1 g1 g1 g1 g1 g1 g1 g1 g1 g1 g1
g1 g1 g1 g1 g1 g1 g1 g1 g1 g1 g1 g1 g1 g1 g1 g1 g1 g1 g1 g1
g1 g1 g1 g1 g1 g1 g1 g1 g1 g1 g1 g1 g1 g1 g1 g1 g1 g1 g1 g1
g1 g1 g1 g1 g1 g1 g1 g1 g1 g1 g1 g1 g1 g1 g1 g1 g1 g1 g1 g1
g1 g1 g1 g1 g1 g1 g1 g1 g1 g1 g1 g1 g1 g1 g1 g1 g1 g1 g1 g1
g1 g1 g1 g1 g1 g1 g1 g1 g1 g1 g1 g1 g1 g1 g1 g1 g1 g1 g1 g1
g1 g1 g1 g1 g1 g1 g1 g1 g1 g1 g1 g1 g1 g1 g1 g1 g1 g1 b2 g1
g1 g1 g1 g1 g1 g1 g1 g1 g1 g1 g1 g1 g1 g1 g1 g1 g1 g1 g1 g1
g1 g1 g1 g1 g1 g1 g1 g1 g1 g1 g1 g1 g1 g1 g1 g1 g1 g1 g1 g1
